######### #
#     #   #
# ### # ###
# #       #
# ####### #
#   #     #
### # #####
#   # #   #
### # ### #
#   #     #
######### #
