#####################
# # #o# # # #o# # # #
#                   #
#                   #
#                   #
#    o              #
#                   #
#           o       #
#                   #
#                   #
#                   #
#####################
