# #     
# ######
# #    #
# #o## #
#o# ##  
# #  #  
# ## #  
#    #  
######  
