############### #######################
#       #       #   o     #       #   #
# ##### # ##### ##### ### ### # # # # #
#     # #   # #     #   #     # # # # #
##### # ### # # ### ### ####### # # ###
#     #   #   #   # # # #   #   # #   #
# ####### ####### # # # # # # ####### #
# #     #     #   # # #   # # # #     #
# # # # ##### # ### # ##### # # # # # #
#   # # #   # # #   #   #   # #   # # #
####### # # # # # ##### # ### ####### #
#     # # #   # # #     #   #         #
# ### # # ##### # # ####### ###########
# # #   #   #   # #       #       #   #
# # # ##### # ######### # ####### ### #
# #   #   #     #       #         #   #
# ##### ####### # # ############### ###
# #   # #     #   #       #     #     #
# # # # # ### ########### # # ### ### #
# # #   #   # #   #     #   #   #   # #
# # ##### # # # # # ### ####### ### # #
# # #     # #   # #   # #     # #   # #
# # ####### ##### ### # # ### ### ### #
# #     # # #   #     #   #       #   #
# ### # # # # # ########### ####### ###
#     #   #   #   #   #   # #     #   #
# ############# # # # ### # ##### ### #
#   #           #   #   #     #   # # #
### # ################# ##### # ### # #
# # # #           #   # #   #       # #
# # # # ### ##### # ### # # # ####### #
# # # # #   #       #   # # # #       #
# # ### # ######### # ### # ### #######
# #     # #     #   # #   #     #   # #
# ####### # ### ##### # ####### # # # #
#   #     # # #       # #   #   # # # #
# # # ### # # ####### # ### # ### # # #
# #     #   #         #     #     #   #
############################### #######
